....................
.......@.....@......
......##############
.....@#....@...@....
......#.............
......#######@......
............###.....
######..@.....##....
..@..######@...#@...
.....@....######....
.............@......
....................
....................
....................