....................
.......@.....@......
.....@##############
.....@#...@....@....
......#@@...........
......#######@......
.@@.........###.....
######.@......##@...
..@..######@...#@...
.......@@.######....
.............@......
....................
....................
....................