........................
........................
.........@.........@....
......##################
.....@#.....@...........
......#.................
......#@................
..@...#.................
#######.................
....@...................
........................
........................