....................
.......@.....@......
......##############
......#...@....@....
......#@@...........
......#######@......
.@@.........###.....
######.@......##@...
..@..######@...#@...
........@.######....
.............@......
....................
....................
....................