....................
.......@.....@......
......##############
......#........@....
......#@............
......#######@......
............###.....
######.@......##....
..@..######@...#@...
..........######....
.............@......
....................
....................
....................